# # 6 # 5 4 9 # #
1 # # # 6 # # 4 2
7 # # # 8 9 # # #
# 7 # # # 5 # 8 1
# 5 # 3 4 # 6 # #
4 # 2 # # # # # #
# 3 4 # # # 1 # #
9 # # 8 # # # 5 #
# # # 4 # # 3 # 7
