5 3 # # 7 # # # #
6 # # 1 9 5 # # #
# 9 8 # # # # # #
8 # # # 6 # # # 3
4 # # 8 # 3 # # 1
7 # # # 2 # # # 6
# 6 # # # # 2 8 #
# # # 4 1 # # # 5
# # # # # # # # 9
