# 9 6 # 4 # # 3 #
# 5 7 8 2 # # # #
1 # # 9 # # 5 # #
# # 9 # 1 # # # 8
5 # # # # # # # 2
4 # # # 9 # 6 # #
# # 4 # # 3 # # 1
# # # # 7 9 2 6 #
# 2 # # 5 # 9 8 #
