# # # 6 # # # 5 2
# # # # 3 1 # 9 #
# # # 8 9 # # # 3
# 7 # # 6 # 5 # #
# # 8 # # # 1 # #
# # 3 # 1 # # 7 #
7 # # # 8 6 # # #
# 3 # 1 7 # # # #
4 6 # # # 3 # # #
