# # # # 1 # # # 2
# # 4 9 # 7 # # #
# # 1 # # # # 6 #
1 # # # 7 # 6 3 #
4 # # 3 # 2 # # 7
# 7 3 # 6 # # # 4
# 9 # # # # 2 # #
# # # 2 # 6 3 # #
8 # # # 5 # # # #
